NO assets/walls/red_eye.png
SO assets/walls/blue_eye.png
WE assets/walls/green_red_eye.png
EA assets/walls/green_eye.png

F 115,36,36
C 64,73,146

        11111
        10001
        10101
        10001
        10001
        10001
        10A01
        11D11
111111110000011111111
100000010000010000001
1X10000D00N00D0000101
100000010000010000001
111111110000011111111
        11D11
        10001
        10001
        10001
        10001
        10101
        10001
        11111