NO assets/walls/red_eye.png
SO assets/walls/blue_eye.png
WE assets/walls/green_red_eye.png
EA assets/walls/green_eye.png

F 115,36,36
C 64,73,146

   111111111  11111   1111111111111     111111111111111111
  11000000W1  10001   10000D00000011    100000000D000000011
 11001111111  10001   10001111000001    11111100111100000011
110011        10001   10001  10000011        1001  1000000011
11001         10001   10001  1000011         1001  10000000011
11001         10001   10001  100011     111111001  100000000011
11001         10001   10001  11D11      100000001  100000000011
11001         10001   10001  100011     111111001  1000000A0011
11001         10001   10001  1000011         1001  10000000011
11001         10001   10001  100000011  111111001  1000000011
 110011111111111D1111110001  10000011111100000001  100X00011
  1100000000D00000000000001  100000000D0000000001  10000011
   111111111111111111111111  11111111111111111111  1111111