NO assets/walls/red_eye.png
SO assets/walls/blue_eye.png
WE assets/walls/green_red_eye.png
EA assets/walls/green_eye.png

F 115,36,36
C 64,73,146

11111111111111111111111111111111111111111111111111111111111111111111111111111
1XD00000000000000000000000000000000000000000000000000000000000000000000000001
1DD00000000000000000000000000000000000000000000000000000000000000000000000001
10000000000000000000000000000000000000000000000000000000000000000000000000001
10000000000000000000000000000000000000000000000000000000000000000000000000001
10000000000000000000000000000000000000000000000000000000000000000000000000001
1000000000000000000000000000000000000000000000000000000A000000000000000000001
10000000000000000000000000000000000000000000000000000000000000000000000000001
10000000000000000000000000000000000000000000000000000000000000000000000000001
10000000000000000000000000000000000000000000000000000000000000000000000000001
10000000000000000000000000000000000000000000000000000000000000000000000000001
10000000000000000000000000000000000000000000000000000000000000000000000000001
10000000000000000000000000000000000000000000000000000000000000000000000000001
10000000000000000000000000000000000000000000000000000000000000000000000000001
10000000000000000000000000000000000000000000000000000000000000000000000000001
10000000000000000000000000000000000000000000000000000000000000000000000000001
10000000000000000000000000000000000000000000000000000000000000000000000000001
10000000000000000000000000000000000000000000000000000000000000000000000000001
10000000000000000000000000000000000000000000000000000000000000000000000000001
10000000000000000000000000000000000000000000000000000000000000000000000000001
100000000000000000000000000DDDDDD00DDDDDDD0000000000000000000000000000000000111111111111111111
10000000000000000000000000DDDDDDDDD0DDDDDDDDDD0000000000000000000000000000000D0000000000000001
111111111111111111111111111DDDDDDDDDDDDDDDDDD1111111111111111111111111111111111111111111111111
1000000000000000000000000000100000000000000000000000000000001000000000000000001000000000000011
100000000000000000000000000010000000000000000000000000000000111111111111111000D00000000000W01
1111111111111111111111111D1110000000000000000000000000000000000000000000000000100000000000001
111111111111111111111111111111111111111111111111111111111111111111111111111111111111111111111