NO assets/walls/red_eye.png
SO assets/walls/blue_eye.png
WE assets/walls/green_red_eye.png
EA assets/walls/green_eye.png

F 115,36,36
C 64,73,146

11111111111111111111111
11111111111111111111111
11111110000000001111111
11111000000000000011111
111100000000000X0001111
11100000000000000000111
11100000000000000000111
11000000000000000000011
11000000000A00000000011
11000000011111000000011
11000000000000000000011
11000000000N00000000011
11000000000000000000011
11000000000000000000011
11000000000000000000011
11000000000000000000011
11100000000D00000000111
11100000000000000000111
11110000000000000001111
11111000000000000011111
11111110000000001111111
11111111111111111111111
11111111111111111111111