NO assets/yellow_square.png
SO assets/blue_square.png
WE assets/red_square.png
EA assets/green_square.png

F 51,153,51
C 51,204,255

11111111111111111111111
11111111111111111111111
11111110000000001111111
11111000000000000011111
11110000000000000001111
11100000000000000000111
11100000000000000000111
11000000000000000000011
11000000000000000000011
11000000000000000000011
11000000000000000000011
11000000000N00000000011
11000000000000000000011
11000000000000000000011
11000000000000000000011
11000000000000000000011
11100000000000000000111
11100000000000000000111
11110000000000000001111
11111000000000000011111
11111110000000001111111
11111111111111111111111
11111111111111111111111