NO assets/walls/red_eye.png
SO assets/walls/blue_eye.png
WE assets/walls/green_red_eye.png
EA assets/walls/green_eye.png

F 51,153,51
C 51,204,255
		
111111111111111111
111111W1    1001
1111111111111111111110