NO assets/walls/red_eye.png
SO assets/walls/blue_eye.png
WE assets/walls/green_red_eye.png
EA assets/walls/green_eye.png

F 51,153,51
C 51,204,255
		
1111111
100D001
1010101
1D0W001
1000S01
100D001
1111111
