NO assets/red_eye.png
SO assets/blue_eye.png
WE assets/green_red_eye.png
EA assets/green_eye.png

F 51,153,51
C 51,204,255

		
1111111
1000001
1000001
100W001
1000001
1000001
1111111
